8 8
. . @ . . . . .
. . . @ . . . .
. . @ . . . . .
. . . . . . . .
. . . . . . . @
. . . . . @ . .
. . . . . . @ .
. . . . . . . .
