8 8
. . @ . . . . .
. . . @ . a . .
. . @ . . . . .
. . . . cc . . .
. . . . . . . @
. . b . . @ . .
. . . . . . @ .
. . . . . . . .
